green
#######################
#######################
##.|.##.........##.|.##
##.|.##....E....##.|.##
##.|.^^.........^^.|.##
##.|...............|.##
##.|.^^...###...^^.|.##
##.|.##.........##.|.##
##.|.##....@....##.|.##
##.|.##.........##.|.##
##.|.##...###...##.|.##
##.|.##...^^^...##.|.##
##.|..g.........g..|.##
##.|...............|.##
#######################
#######################