orange
###########################
###########################
##........##...##........##
##........vv...vv........##
##.E.....................##
##.....o..^^.o.^^..o.....##
##........##...##........##
#######################|###
##...vv.|.vv.|.vv.|.vv.|.##
##......|....|....|....|.##
##.@...................|.##
##.......................##
#####~~~~~~~~~~~~~~~~~#####
######~~~~~~~~~~~~~~~######
########~~~~~~~~~~~########
###########################