purple
#############
#############
##.|..E..|.##
##.|.....|.##
##.|.....|.##
##.|.###.|.##
##>|<#~#>|<##
##.|.###.|.##
##.|.....|.##
##.|..p..|.##
##.|.....|.##
##.|.###.|.##
##>|<#~#>|<##
##.|.###.|.##
##.|.....|.##
##.|..p..|.##
##.|.....|.##
##.|.###.|.##
##>|<#~#>|<##
##.|.###.|.##
##.|.....|.##
##.|..p..|.##
##.|.....|.##
##.|.###.|.##
##>|<#~#>|<##
##.|.###.|.##
##.|.....|.##
##.|..@..|.##
##.........##
#############
#############