blue
#################
#################
##.............##
##...........E.##
##.........b...##
##.............##
##.......|#######
##.......|#######
##.....b..vv#####
##..........#####
##...|##....#####
##...|##....#####
##b...vv....#####
##..........#####
####|.......#####
####|.......#####
##vv..b.....#####
##..........#####
##....##|...#####
##....##|......##
##....vv.......##
##.............##
##~~~~~~~~##.@.##
##~~~~~~~~##...##
#################
#################