purple
################
################
##.E..........##
##..........p.##
##............##
#####>....<#####
##............##
##....|##|....##
##.p..|##|..p.##
##............##
####>......<####
##............##
##....|##|....##
##.p..|##|..p.##
##............##
####>......<####
##............##
##....|##|....##
##.p..|##|..@.##
##............##
#####~~~~~~#####
######~~~~######
#######~~#######
################
################