yellow
#####################
##...........########
##.............######
######|####.....|...#
#...P.|...###...|...#
#.....|...#####.|...#
##################|##
#.................|.#
#.................|.#
#.................|.#
#...................#
#####################