blue
#################
#################
##.E....|...#####
##......|...#####
##......|...#####
#####>..|....b.##
#####>..|......##
##.b....|..<#####
##......|..<#####
#####>..|....b.##
#####>..|......##
##.b....|..<#####
##......|..<#####
#####>..|....b.##
#####>..|......##
##......|..<#####
##......|..<#####
##.@....|......##
##.............##
#####~~~~~~~~~~##
#####~~~~~~~~~~##
#################
#################