orange
############################
############################
##..^^^^..####...######...##
##.........^^.....^^^^....##
##.E......................##
##....o....^^......o......##
##........####............##
########################|###
##....^^.|.^^.|.^^.|.^^.|.##
##.......|....|....|....|.##
##.@....................|.##
##........................##
######~~~~~~~~~~~~~~~~~#####
#######~~~~~~~~~~~~~~~######
#########~~~~~~~~~~~########
############################