red
#####################
##...........########
##.............######
######|####.....|...#
#..P..|...###...|...#
#.....|...#####.|...#
#########.########|##
#.................|.#
#.................|.#
#.................|.#
#......bb.........|.#
#...................#
#####################