orange
####################
####################
##....E...........##
##................##
##................##
##...###|.........##
##...^^^..........##
##...........^....##
##.........|###...##
##..........^^^...##
##....^...........##
##...###|.........##
##...^^^..........##
##...........^....##
##.........|###...##
##..........^^^...##
##....^...........##
##...###|.........##
##...^^^..........##
##...........^....##
##.........|###...##
##....@.....^^^...##
##................##
##~~~###~~~~~~~~~~##
##~~~###~~~~~~~~~~##
####################
####################