orange
#########################
#########################
##.....................##
##.....................##
##.....................##
##.....................##
##.....................##
##.....................##
##.....................##
##.................E...##
##..@..................##
##.....................##
#########################
#########################