green
#####################
#####################
##.vvv.#######.vvv.##
##......#####......##
##.......###.......##
##.................##
##........2........##
##.................##
##.......###....E..##
##..@...#####......##
##.....#######.....##
#####################
###~~~#########~~~###
#####################
#####################