orange
#####################
#####################
##.....#######.....##
##......#####......##
##.......###.......##
##.................##
##........1........##
##.................##
##.......###....E..##
##..@...#####......##
##.....#######.....##
#####################
#####################