green
#######################
#######################
#######.vv...vv.#######
#######....E....#######
##.|.vv.........vv.|.##
##.|...............|.##
##.|.^^...###...^^.|.##
##.|.##.........##.|.##
##.|.##....@....##.|.##
##.|.##.........##.|.##
##.|.##...###...##.|.##
##.|......vvv......|.##
##.|.g...........g.|.##
##...................##
#######################
#######################