orange
####################
####################
##..............E.##
##.o..............##
##................##
#####|||############
##...|||..........##
##...|||.....o....##
##................##
##~~~~~~~~~#####|###
################|###
##.......^^.....|.##
##..............|.##
##.@............|.##
##...^^......^^...##
####################
####################