orange
####################
####################
##..............E.##
##..o.......o.....##
##................##
########|###########
########|###########
##......|.........##
##......|.........##
##................##
##.....###........##
##~~~~~~~~~~~~~#|###
###~~~~~~~~~~~##|###
################|###
##.......vv.....|.##
##..............|.##
##.@............|.##
##...^^......^^...##
####################
####################