green
#####################
##...........########
##.......^.....######
######|####.....|...#
#.....|...###...|...#
#..@..|...#####.|...#
#.........########|##
#########.........|.#
#.................|.#
#.E...............|.#
#......gg....###..|.#
#.....^^^...........#
###########~~~~~~~###
############~~~~~####
#############~~~#####
##############~######
#####################