yellow
#############################
#############################
##....#.......#.......#....##
##....#.......#.......#....##
##....v.......v.......v....##
##.........................##
##.......................E.##
##.@.^^^..y..^^^..y..^^^...##
##...###.....###.....###...##
#############################
#########~~~#####~~~#########
#############################
#############################